1111111111111111111111111111
1E00100000000000000000000001
1000111000000000000000000001
10C0000000000000000000000001
10000000000000000000000E0001
10P0000000000000000000000001
1111111111111111111111111111